name Small Labyrinth of Dooom
win 8
####################
#....G.............#
#G..........G......#
##################.#
#..................#
#..................#
#.....###........###
#......G...........#
#..................#
#...........E......#
#......G.........G.#
#........G.....G...#
#..........###.....#
#..................#
####################
