name Small Labyrinth of Dooom
win 3
####################
#..................#
#..................#
#..................#
#..................#
#..................#
#.....###........###
#......G...........#
#..................#
#...........E......#
#......G.........G.#
#........G.....G...#
#..........###.....#
#..................#
####################
