name test3
win 5
####################
#........#.........#
#..G...G.#.........#
#........#.........#
#........#..G......#
#........#.........#
#.......G#########.#
#........#E........#
#.#########........#
#.........#........#
#...G.....#........#
#.........#........#
#.....G...#........#
#..................#
####################
