name test4
win 5
####################
#..#........#...E..#
#..#..#....G#......#
#..#G.#....##......#
#..#..#....#.......#
#..####.########...#
#..............##..#
#########.......#..#
#....#.G#..........#
#.#..#..#..........#
#.#G.#..##########.#
#.####...##........#
#..................#
#..............G...#
####################
